Umno chief	Malaysian  Parliament	meets Malaysian
royal kuala rulers	16 covid-19 crisis	begun
ongoing party which	six  weeks	granted
royal datuk indera	fadil tuesday	met
independent  it	independent  tuesday	said
experts	various government 2	scheduled
malay one	october	held in
state	january	declared amid
emergency	worsening covid-19 health crisis	been
nation	recent  weeks	is
constitutional  move	poorer  malaysians	said
financial  people	outbreak	told
that	1969 race king	mahathir
ruling opposition that	stronger  majority	claimed
civil  that	police	made
dr mahathir	covid-19 pandemic	suggested including
it	emergency	opposed
year  outbreak	year  budget	called for
also muhyiddin administration	power	suspends
tan sri muhyiddin	gradually exit economy	unveiled
country	sabah state september	failed
late  malaysia	1,200 covid-19 cases	reporting
it	5,419  cases	recorded
subscriber log inconvenience	subscriber log ins	experiencing
subscribers	digital  articles	log
log in	still  pdfs	required for
gabungan parti sarawak	malaysian borneo monday	highlighted
last al mustafa billah	last party wednesday	were
they	three covid-19 battle	said
vaccination programme	herd immunity	is
well  statement	strong covid-19 programme	read
economic exit statement	economic exit plan	added
abdul rahman zohari	pesaka bumiputera bersatu	abang
four  parties	general  election	formed in
it	political  stability	said
which	year  january	postponed
king al-â€‹sultan king abdullah	fellow malay emergency	said
also  parliament	national zahid hamidi	said
state	thin mr hold	suspended since
meanwhile  he	currently operations councilto country	said
daily  cases	first  month	dropped below
country	covid-19 works	said on
email you	email address	looks like
current party president	al sultan friday	says
democratic  system	sultan  abdullah	told
previously covid-19 he	previously covid-19 pandemic	added
bagan datuk member	also parliament sittings	proposed
parliament	such loan moratoriums	believes
other  he	other  everyone	said
openly  latter	former	is
federal  latter	allegedly parliament emergency	anwar
suspension	executive government pandemic	reported
also  who	king	was
he	component pakatan harapan coalition	granted
also  he	present operations circumstances	had
mageran	racial  country	set
political  leaders	since dr mageran	challenged
idea	emergency period	told
he	mageran  king	added
other ahmad zahid	other  purposes	said
parliament	belief	said
they	them	said
also parliament sittings	physical  means	called for
dap  politician	parliamentary  democracy	wrote
santiago	same  no	expressed
him	emptive covid-19 country	santiago
pandemic  he	pandemic  country	added
earlier  i	just  that	follow
forever  muhyiddin	such  regulations	said
sultan  abdullah	special covid-19 conference	slated
succession	political  leaders	set
he	ruling party gabungan monday	slated
ongoing  parliament	friday	proposed
seri ahmad zahid hamidi	sultan abdullah ahmad shah	told
covid-19 zahid	covid-19 emergency	said
king	national party it	meeting political
prime  minister	national operations emergency	proposed
he	council	offered
ruling opposition that	stronger  majority	said
government	pandemic	meeting
it	august	is due
this	two  june	announced
indian  which	bersatu  sabah	meeting
democratic action lim	eng	met prime
online  meeting	ruling party gabungan monday	is
king	emergency  crisis	meeting
subscriber log inconvenience	subscriber log ins	experiencing
subscribers	digital  articles	log
log in	still  pdfs	required for
1  president	zahid jun	pleaded with
ahmad zahid	palace	told
opposition anwar opposition who	mustafa billah shah	echoed
al sultan abdullah	political party meetings	summoning political
prime  minister	general lim guan wednesday	met with prime
minister mahathir who	registered pejuang tanah air	had
bersatu maximus johnity leaders	virtual  monday	included mic
al sultan abdullah	back  covid-19	declared
total  caseload	active  cases	continued
parliamentary  legitimacy	august power house	challenged in
pandemic	control	said
damage	too  country	said
previously covid-19 he	previously covid-19 pandemic	said
government administration	checks	added
sinar	increasing  goods	is of
other  he	fund withdrawal programmes	said
this	king	said
immediately  parliament	emergency	rejected
king	special malay emergency	said
email you	email address	looks like
